NO ./path_to_the_north_texture
SO ./path_to_the_south_texture
WE ./path_to_the_west_texture
EA ./path_to_the_east_texture

       C                        225         , 30,64
F 220,                   100,100   

11111111111111111111111111111111
1000000000110000000000001       
1011000001110000000000001        
100100000000000000000000111111111
1111111110110000 01110000000000001
10000000001100000111011111111111111111
11110011111111011100001     1   
1111001111        
11000 000110101011100000010001   
10000000000000001100000010001    
1000000000 0000001101010010001
1100N0011101010111110111100111
11110111111110101101111010001
11111111111111111111111111111











