NO          ./textures/north.xpm
SO  ./textures/south.xpm
WE               ./textures/west.xpm
EA ./textures/east.xpm

F 255 ,                 0,                 0
C 0,                 0,            0

1111111111111111111111111
1000000000110000000000001
1011000001110000000000001
1001000000000000000000001
1111111110110000011100001
1000000000110000011101111
1111011111111101110000001
1111011111111101110101001
1100000011010101110000001
1000000000000000110000001
1000000000000000110101001
1100000110010101111101111
1111011110110101101111010000000000000000000 1
1111111110111111111111111
1111111110111111111111111
1000000000110000                          000000001
1011000011110000000000001
1001000 N 00000000000000001
1111111110110000011100001
1000000000110000011101111
1111011111111101110000001
1111011111111101110101001
1100000011010101110000001
1000000000000000110000001
1000000000000000110101001
1100000111010101111101111
1111011111110101101111011
1111111111111 111111111111
